万	萬
与	與
丑	醜
丒	囟
专	專
丗	卅
丘	丘
业	業
丛	叢
东	東
丝	絲
両	兩
丢	丟
两	兩
严	嚴
丧	喪
丨	｜
个	個
丬	爿
丯	丰
丰	豐
临	臨
丶	⼂
为	為
丽	麗
举	舉
丿	⼃
乃	乃
么	麼
义	義
乌	烏
乐	樂
乔	喬
习	習
乡	鄉
书	書
买	買
乱	亂
亀	龜
亁	乾
了	了
争	爭
亏	虧
云	雲
亘	亙
亚	亞
亠	⼇
产	產
亩	畝
亲	親
亵	褻
亸	嚲
亻	人
亿	億
仅	僅
仆	僕
从	從
仑	崙
仓	倉
他	他
仙	仙
仪	儀
们	們
仮	假
价	價
仿	仿
众	眾
优	優
会	會
伛	傴
伞	傘
伟	偉
传	傳
伤	傷
伥	倀
伦	倫
伧	傖
伪	偽
伫	佇
伲	抳
佑	佑
体	體
佛	佛
你	你
佣	佣
佥	僉
佩	佩
侄	侄
侠	俠
侣	侶
侥	僥
侦	偵
侧	側
侨	僑
侩	儈
侪	儕
侬	儂
俣	俁
俦	儔
俨	儼
俩	倆
俪	儷
俭	儉
倮	惈
债	債
倾	傾
偬	傯
偻	僂
偾	僨
偿	償
傈	慄
傥	儻
傧	儐
储	儲
傩	儺
僵	殭
儿	兒
兀	兀
克	克
兎	兔
兑	兌
兖	兗
党	黨
兪	俞
兰	蘭
关	關
兴	興
兹	茲
养	養
兽	獸
兾	糞
兿	藝
冁	囅
冂	⼌
内	內
円	丹
冈	岡
册	冊
冖	⼍
写	寫
军	軍
农	農
冝	宜
冢	塚
冦	寇
冧	霖
冨	富
冩	寫
冫	⼎
冮	江
冯	馮
冲	衝
决	決
况	況
冸	泮
冺	泯
冻	凍
冿	津
净	淨
凁	涑
凂	浼
凃	涂
凄	淒
准	准
凇	淞
凉	涼
减	減
凑	湊
凒	溰
凓	溧
凕	溟
凖	準
凙	澤
凚	澿
凛	凜
凟	瀆
几	幾
凤	鳳
凥	尻
処	處
凨	云
凫	鳧
凬	凰
凭	憑
凮	鳳
凯	凱
凴	憑
凶	凶
出	出
击	擊
凼	窞
凾	亟
凿	鑿
刄	刃
刅	刃
刋	刊
刍	芻
划	劃
刘	劉
则	則
刚	剛
创	創
删	刪
刦	劫
刧	劫
刨	刨
别	別
刭	剄
刮	刮
刴	剁
制	制
刹	剎
刼	劫
刽	劊
刿	劌
剀	剴
剂	劑
剃	剃
剐	剮
剑	劍
剥	剝
剧	劇
剰	剩
劎	劍
劒	劍
劔	劍
劝	勸
办	辦
务	務
劢	勱
动	動
励	勵
劲	勁
劳	勞
労	勞
劵	卷
効	效
劽	裂
势	勢
勅	敕
勋	勛
勐	猛
勚	勩
勠	戮
勥	強
勧	勸
勲	勳
勹	⼓
匀	勻
匦	匭
匮	匱
区	區
医	醫
匾	匾
千	千
升	升
华	華
协	協
单	單
卖	賣
単	單
卙	斟
卛	攣
卜	卜
卟	嚇
占	占
卢	盧
卤	鹵
卥	囟
卧	臥
卩	⼙
卫	衛
却	卻
卷	卷
卺	巹
厂	廠
厅	廳
历	歷
厉	厲
压	壓
厌	厭
厍	厙
厕	廁
厛	廳
厠	廁
厢	廂
厣	厴
厦	廈
厨	廚
厩	廄
厮	廝
厰	廠
厳	嚴
厶	⼛
县	縣
叁	參
参	參
叄	參
叆	靉
叇	靆
双	雙
収	收
叏	發
叐	發
发	發
变	變
叙	敘
叠	疊
叧	另
只	只
台	台
叶	葉
号	號
叹	嘆
叽	嘰
吁	籲
吊	吊
同	同
后	後
向	向
吓	嚇
吕	呂
吖	嗄
吗	嗎
吣	唚
吨	噸
听	聽
启	啟
吴	吳
吿	告
呆	呆
呋	咐
呐	吶
呑	吞
呒	嘸
呓	囈
呕	嘔
呖	嚦
呗	唄
员	員
呙	咼
呛	嗆
呜	嗚
周	周
呪	咒
和	和
咏	詠
咔	哢
咙	嚨
咛	嚀
咝	吱
咣	光
咤	吒
咴	噅
咸	咸
咽	咽
哄	哄
哌	呱
响	響
哐	匡
哑	啞
哒	噠
哓	嘵
哔	嗶
哕	噦
哗	嘩
哙	噲
哜	嚌
哝	噥
哟	喲
哺	哺
唛	嘜
唝	嗊
唠	嘮
唡	啢
唢	嗩
唣	嗦
唤	喚
唿	呼
啉	咻
啕	啕
啧	嘖
啬	嗇
啭	囀
啮	嚙
啰	囉
啴	嘽
啸	嘯
喧	喧
喷	噴
喹	奎
喽	嘍
喾	嚳
嗀	嗀
嗉	膆
嗪	唚
嗫	囁
嗬	呵
嗳	噯
嗵	通
嘘	噓
嘞	咧
嘠	嘎
嘣	迸
嘤	嚶
嘨	嘯
嘭	膨
嘱	囑
嘷	嚎
噔	登
噜	嚕
噪	噪
噻	塞
噼	劈
嚔	涕
嚢	囊
嚣	囂
嚯	謔
回	回
团	團
园	園
困	困
囱	囪
围	圍
囵	圇
国	國
图	圖
圆	圓
圣	聖
圹	壙
场	場
坂	阪
坏	壞
块	塊
坚	堅
坛	壇
坜	壢
坝	壩
坞	塢
坟	墳
坠	墜
垄	壟
垅	壟
垆	壚
垒	壘
垦	墾
垧	坰
垩	堊
垫	墊
垭	埡
垲	塏
垴	瑙
埘	塒
埙	塤
埚	堝
埝	墊
埯	垵
堑	塹
堕	墮
堤	堤
塡	填
塬	原
墒	墑
墙	牆
壮	壯
声	聲
壳	殼
壶	壺
壸	壼
夂	⼢
处	處
备	備
夊	⼢
复	複
够	夠
夫	夫
头	頭
夸	誇
夹	夾
夺	奪
奁	奩
奂	奐
奋	奮
奖	獎
奥	奧
奸	奸
妆	妝
妇	婦
妈	媽
妩	嫵
妪	嫗
妫	媯
姗	姍
姜	姜
姹	奼
娄	婁
娅	婭
娆	嬈
娇	嬌
娈	孌
娘	娘
娱	娛
娲	媧
娴	嫻
婳	嫿
婴	嬰
婵	嬋
婶	嬸
媪	媼
嫒	嬡
嫔	嬪
嫱	嬙
嬷	嬤
孙	孫
学	學
孪	孿
孶	孳
宀	⼧
宁	寧
它	它
宝	寶
实	實
宠	寵
审	審
宪	憲
宫	宮
宴	宴
家	家
宽	寬
宾	賓
寝	寢
对	對
寻	尋
导	導
対	對
寿	壽
専	專
尅	剋
将	將
尓	爾
尔	爾
尘	塵
尝	嘗
尧	堯
尴	尷
尽	盡
局	局
层	層
屃	屭
屉	屜
届	屆
屛	屏
属	屬
屡	屢
屦	屨
屿	嶼
岁	歲
岂	豈
岖	嶇
岗	崗
岘	峴
岙	嶴
岚	嵐
岛	島
岜	岊
岭	嶺
岳	岳
岺	岭
岽	崠
岿	巋
峃	嶨
峄	嶧
峡	峽
峣	嶢
峤	嶠
峥	崢
峦	巒
峯	峰
崂	嶗
崃	崍
崄	嶮
崭	嶄
崾	要
嵘	嶸
嵚	嶔
嵛	崳
嵝	嶁
嵴	
巄	巃
巅	巔
巌	巖
巓	巔
巛	⼮
巩	鞏
巯	巰
币	幣
布	布
帅	帥
师	師
帏	幃
帐	帳
帘	簾
帜	幟
带	帶
帧	幀
席	席
帮	幫
帯	帶
帱	幬
帻	幘
帼	幗
幂	冪
幇	幫
幚	幫
幞	襆
干	幹
并	並
幷	并
幸	幸
幺	么
广	廣
庁	廳
広	麼
庄	莊
庅	麼
庆	慶
庐	廬
庑	廡
库	庫
应	應
庙	廟
庞	龐
废	廢
庼	廎
廏	廄
廐	廄
廪	廩
廴	⼵
廵	巡
开	開
异	異
弃	棄
弄	弄
弑	弒
张	張
弥	彌
弦	弦
弪	弳
弯	彎
弹	彈
强	強
彐	⼹
归	歸
当	當
录	錄
彚	彙
彛	羿
彜	羿
彝	彞
彟	獲
彠	獲
彡	⼺
彦	彥
彩	彩
彷	徬
彻	徹
径	徑
徇	徇
徕	徠
御	御
徸	德
忄	心
忆	憶
忏	懺
志	志
忧	憂
念	念
忾	愾
怀	懷
态	態
怂	慫
怃	憮
怄	慪
怅	悵
怆	愴
怜	憐
总	總
怼	懟
怿	懌
恋	戀
恒	恆
恤	恤
恳	懇
恶	惡
恸	慟
恹	懨
恺	愷
恻	惻
恼	惱
恽	惲
悦	悅
悫	愨
悬	懸
悭	慳
悯	憫
惊	驚
惧	懼
惨	慘
惩	懲
惫	憊
惬	愜
惭	慚
惮	憚
惯	慣
惽	惛
愈	愈
愠	慍
愤	憤
愦	憒
愿	願
慑	懾
慭	憖
憷	楚
懑	懣
懒	懶
懔	懍
懴	懺
戅	戇
戆	戇
戋	戔
戏	戲
戗	戧
战	戰
戚	戚
戝	敗
戦	戰
戬	戩
戯	戲
戱	戲
户	戶
戸	戶
扁	扁
扌	手
扎	扎
扑	撲
托	托
扣	扣
执	執
扩	擴
扪	捫
扫	掃
扬	揚
扰	擾
抅	拘
抚	撫
抛	拋
抟	摶
抠	摳
抡	掄
抢	搶
护	護
报	報
担	擔
拐	拐
拟	擬
拢	攏
拣	揀
拥	擁
拦	攔
拧	擰
拨	撥
择	擇
挂	挂
挚	摯
挛	攣
挜	掗
挝	撾
挞	撻
挟	挾
挠	撓
挡	擋
挢	撟
挣	掙
挤	擠
挥	揮
挦	撏
挽	挽
捂	捂
捞	撈
损	損
捡	撿
换	換
捣	搗
据	據
捻	捻
掏	掏
掳	擄
掴	摑
掷	擲
掸	撣
掺	摻
掼	摜
揸	喳
揽	攬
揿	撳
搀	攙
搁	擱
搂	摟
搃	摠
搅	攪
携	攜
摄	攝
摅	攄
摆	擺
摇	搖
摈	擯
摊	攤
撃	擊
撄	攖
撑	撐
撪	攆
撰	撰
撵	攆
撷	擷
撸	擼
撹	攪
撺	攛
擕	攜
擞	擻
擡	抬
擥	掔
擧	舉
擪	壓
攒	攢
攴	⽁
攵	又
敇	敕
效	效
敌	敵
敛	斂
敦	敦
敮	歃
数	數
斉	齊
斋	齋
斎	齋
斓	斕
斗	斗
斩	斬
断	斷
无	無
旧	舊
时	時
旷	曠
旸	暘
昂	昂
昆	昆
昙	曇
昵	暱
昼	晝
昽	曨
显	顯
晋	晉
晒	曬
晓	曉
晔	曄
晕	暈
晖	暉
暂	暫
暧	曖
札	札
术	術
朱	朱
朴	樸
机	機
杀	殺
杂	雜
权	權
杆	桿
条	條
来	來
杨	楊
杩	榪
杯	杯
杰	傑
松	松
板	板
极	極
构	構
枞	樅
枢	樞
枣	棗
枥	櫪
枧	見
枨	棖
枪	槍
枫	楓
枭	梟
柜	櫃
柠	檸
柽	檉
栀	梔
栅	柵
标	標
栈	棧
栉	櫛
栊	櫳
栋	棟
栌	櫨
栎	櫟
栏	欄
树	樹
栖	棲
栗	慄
样	樣
栾	欒
桊	棬
桠	椏
桡	橈
桢	楨
档	檔
桤	榿
桥	橋
桦	樺
桧	檜
桨	槳
桩	樁
梁	梁
梦	夢
梼	檮
梾	棶
检	檢
棂	欞
棱	棱
椁	槨
椟	櫝
椠	槧
椤	欏
椭	橢
楼	樓
楽	樂
榄	欖
榇	櫬
榈	櫚
榉	櫸
榘	矩
榨	榨
槚	檟
槛	檻
槟	檳
槠	櫧
横	橫
樯	檣
樱	櫻
橥	櫫
橱	櫥
橹	櫓
橼	櫞
檐	簷
檩	檁
檪	櫟
檫	察
欢	歡
欣	欣
欤	歟
欧	歐
欲	欲
歳	歲
歴	曆
歺	歲
歼	殲
殁	歿
殇	殤
残	殘
殒	殞
殓	殮
殚	殫
殡	殯
殱	殲
殴	毆
毁	毀
毂	轂
毕	畢
毙	斃
毡	氈
毵	毿
毶	鞠
氇	氌
气	氣
気	氣
氢	氫
氩	氬
氲	氳
氵	水
氽	汆
汇	匯
汉	漢
污	污
汤	湯
汹	洶
沟	溝
没	沒
沣	灃
沤	漚
沥	瀝
沦	淪
沧	滄
沨	渢
沩	溈
沪	滬
沵	濔
沾	沾
泄	洩
泛	泛
泞	濘
注	注
泪	淚
泶	澩
泷	瀧
泸	瀘
泺	濼
泻	瀉
泼	潑
泽	澤
泾	涇
洁	潔
洒	灑
洼	窪
浃	浹
浅	淺
浆	漿
浇	澆
浈	湞
浉	溮
浊	濁
测	測
浍	澮
济	濟
浏	瀏
浐	滻
浑	渾
浒	滸
浓	濃
浔	潯
浕	濜
浜	濱
涂	塗
涌	湧
涙	淚
涛	濤
涝	澇
涞	淶
涟	漣
涠	潿
涡	渦
涢	溳
涣	渙
涤	滌
润	潤
涧	澗
涨	漲
涩	澀
淀	澱
渊	淵
渌	淥
渍	漬
渎	瀆
渐	漸
渑	澠
渔	漁
渖	瀋
渗	滲
温	溫
游	游
湼	涅
湾	灣
湿	濕
溃	潰
溅	濺
溆	漵
溇	漊
溪	溪
滗	潷
滙	匯
滚	滾
滝	瀧
滞	滯
滟	灩
滠	灄
满	滿
滢	瀅
滤	濾
滥	濫
滦	灤
滨	濱
滩	灘
滪	澦
漑	溉
漓	漓
漤	灠
潆	瀠
潇	瀟
潋	瀲
潍	濰
潜	潛
潴	瀦
澄	澄
澜	瀾
濑	瀨
濒	瀕
灎	灩
灏	灝
灔	灩
灜	瀛
灧	灩
灬	火
灭	滅
灯	燈
灵	靈
灾	災
灿	燦
炀	煬
炉	爐
炖	燉
炜	煒
炝	熗
炫	炫
炮	炮
点	點
炼	煉
炽	熾
烁	爍
烂	爛
烃	烴
烛	燭
烟	煙
烦	煩
烧	燒
烨	燁
烩	燴
烫	燙
烬	燼
热	熱
焊	焊
焕	煥
焖	燜
焘	燾
焰	焰
煅	煆
煳	糊
煺	退
熏	熏
熔	熔
熘	溜
爱	愛
爲	為
爷	爺
牍	牘
牜	牛
牦	犛
牵	牽
牺	犧
犊	犢
犏	゛
犟	強
犭	犬
状	狀
犷	獷
犸	馬
犹	猶
狈	狽
狍	包
狝	獮
狞	獰
独	獨
狭	狹
狮	獅
狯	獪
狰	猙
狱	獄
狲	猻
猃	獫
猎	獵
猕	獼
猡	玀
猪	豬
猫	貓
猬	蝟
献	獻
獭	獺
玑	璣
玙	璵
玚	瑒
玛	瑪
玮	瑋
环	環
现	現
玱	瑲
玺	璽
珉	氏
珏	玨
珐	琺
珑	瓏
珰	璫
珱	瓔
珲	琿
球	球
琅	琅
琎	璡
琏	璉
琐	瑣
琼	瓊
瑶	瑤
瑷	璦
璎	瓔
瓒	瓚
瓮	甕
瓯	甌
瓶	瓶
産	產
电	電
画	畫
畅	暢
畲	畬
畳	疊
畴	疇
畵	畫
疃	畽
疎	疏
疒	⽧
疖	癤
疗	療
疟	瘧
疠	癘
疡	瘍
疬	癆
疮	瘡
疯	瘋
疱	皰
疴	痾
症	症
痈	癰
痉	痙
痒	癢
痖	啞
痨	癆
痩	瘦
痪	瘓
痫	癇
痬	瘍
痴	癡
痹	痺
瘅	癉
瘆	疹
瘗	瘞
瘘	瘺
瘪	癟
瘫	癱
瘾	癮
瘿	癭
癀	廣
癍	斑
癎	癇
癞	癩
癣	癬
癫	癲
癯	臒
発	發
皀	皂
皑	皚
皱	皺
皲	皸
盏	盞
盐	鹽
监	監
盖	蓋
盗	盜
盘	盤
県	縣
眍	區
眞	真
眦	眥
眬	矓
眯	瞇
着	著
睁	睜
睐	睞
睑	瞼
睾	睾
瞒	瞞
瞩	矚
矤	病
矫	矯
矶	磯
矾	礬
矿	礦
砀	碭
码	碼
砖	磚
砗	硨
砚	硯
砜	風
砺	礪
砻	礱
砾	礫
础	礎
硁	硜
硕	碩
硖	硤
硗	磽
硙	磑
硚	礄
确	確
硷	鹼
碍	礙
碛	磧
碜	磣
碱	鹼
碹	宣
磙	袞
磷	磷
礴	礡
礻	示
礼	禮
祎	禕
祢	禰
祯	禎
祷	禱
祸	禍
禀	稟
禄	祿
禅	禪
离	離
秃	禿
秆	稈
秋	秋
种	種
秘	秘
积	積
称	稱
移	移
秽	穢
秾	穠
稆	穭
税	稅
稣	穌
稳	穩
穑	穡
穷	窮
窃	竊
窍	竅
窑	窯
窛	刂
窜	竄
窝	窩
窥	窺
窦	竇
窭	窶
竖	豎
竜	龍
竞	競
笃	篤
笋	筍
笔	筆
笕	筧
笺	箋
笼	籠
笾	籩
筋	筋
筑	築
筚	篳
筛	篩
筜	簹
筝	箏
筢	把
筹	籌
签	簽
简	簡
箓	籙
箢	宛
箦	簀
箧	篋
箨	籜
箩	籮
箪	簞
箫	簫
篑	簣
篓	簍
篮	籃
篱	籬
篼	兜
簖	籪
籁	籟
籴	糴
类	類
籼	秈
粜	糶
粝	糲
粤	粵
粪	糞
粮	糧
糁	糝
糇	餱
糟	糟
糹	糸
系	系
紧	緊
累	累
絵	繪
絶	絕
絷	縶
綘	健
継	繼
続	續
緜	綿
縂	總
縄	繩
繋	繫
繍	繡
纟	糸
纠	糾
纡	紆
红	紅
纣	紂
纤	纖
纥	紇
约	約
级	級
纨	紈
纩	纊
纪	紀
纫	紉
纬	緯
纭	紜
纮	紘
纯	純
纰	紕
纱	紗
纲	綱
纳	納
纴	紝
纵	縱
纶	綸
纷	紛
纸	紙
纹	紋
纺	紡
纻	紵
纼	紖
纽	紐
纾	紓
线	線
绀	紺
绁	紲
绂	紱
练	練
组	組
绅	紳
细	細
织	織
终	終
绉	縐
绊	絆
绋	紼
绌	絀
绍	紹
绎	繹
经	經
绐	紿
绑	綁
绒	絨
结	結
绔	褲
绕	繞
绖	絰
绗	絎
绘	繪
给	給
绚	絢
绛	絳
络	絡
绝	絕
绞	絞
统	統
绠	綆
绡	綃
绢	絹
绣	繡
绤	綌
绥	綏
绦	絛
继	繼
绨	綈
绩	績
绪	緒
绫	綾
续	續
绮	綺
绯	緋
绰	綽
绱	鞜
绲	緄
绳	繩
维	維
绵	綿
绶	綬
绷	繃
绸	綢
绹	綯
绺	綹
绻	綣
综	綜
绽	綻
绾	綰
绿	綠
缀	綴
缁	緇
缂	緙
缃	緗
缄	緘
缅	緬
缆	纜
缇	緹
缈	緲
缉	緝
缊	縕
缋	繢
缌	緦
缍	綞
缎	緞
缏	緶
缐	線
缑	緱
缒	縋
缓	緩
缔	締
缕	縷
编	編
缗	緡
缘	緣
缙	縉
缚	縛
缛	縟
缜	縝
缝	縫
缞	縗
缟	縞
缠	纏
缡	縭
缢	縊
缣	縑
缤	繽
缥	縹
缦	縵
缧	縲
缨	纓
缩	縮
缪	繆
缫	繅
缬	纈
缭	繚
缮	繕
缯	繒
缰	韁
缱	繾
缲	繰
缳	繯
缴	繳
缵	纘
罂	罌
网	網
罗	羅
罚	罰
罢	罷
罴	羆
羁	羈
羗	羌
羟	羥
羡	羨
羣	群
羮	羹
翘	翹
翙	翽
翚	翬
考	考
耠	
耢	勞
耥	尚
耧	耬
耸	聳
耻	恥
聂	聶
聋	聾
职	職
聍	聹
联	聯
聩	聵
聪	聰
肀	聿
肃	肅
肠	腸
肤	膚
肮	骯
肴	肴
肷	欠
肾	腎
肿	腫
胀	脹
胁	脅
胄	胄
胆	膽
背	背
胜	勝
胡	胡
胧	朧
胨	東
胪	臚
胫	脛
胶	膠
脉	脈
脍	膾
脏	髒
脐	臍
脑	腦
脓	膿
脔	臠
脚	腳
脱	脫
脲	反
脶	腡
脸	臉
腊	臘
腌	醃
腘	膕
腭	齶
腻	膩
腼	靦
腽	膃
腾	騰
膑	臏
臓	摹
臜	臢
致	致
舆	輿
舍	舍
舣	艤
舰	艦
舱	艙
舻	艫
艰	艱
艳	艷
艹	艸
艺	藝
节	節
芈	羋
芗	薌
芜	蕪
芦	蘆
芸	蕓
苁	蓯
苄	芐
苇	葦
苈	藶
苋	莧
苌	萇
苍	蒼
苎	苧
苏	蘇
苘	萵
苷	甘
苹	蘋
范	範
茎	莖
茏	蘢
茑	蔦
茔	塋
茕	煢
茧	繭
荆	荊
荐	薦
荙	薘
荚	莢
荛	蕘
荜	蓽
荞	蕎
荟	薈
荠	薺
荡	蕩
荣	榮
荤	葷
荥	滎
荦	犖
荧	熒
荨	蕁
荩	藎
荪	蓀
荫	蔭
荬	賣
荭	葒
荮	紂
药	藥
莅	蒞
莜	蓨
莱	萊
莲	蓮
莳	蒔
莴	萵
莶	薟
获	獲
莸	蕕
莹	瑩
莺	鶯
莼	蓴
菭	恰
萚	蘀
萝	蘿
萤	螢
营	營
萦	縈
萧	蕭
萨	薩
葱	蔥
蒇	蕆
蒉	蕢
蒋	蔣
蒌	蔞
蒙	蒙
蓑	蓑
蓝	藍
蓟	薊
蓠	蘺
蓣	蕷
蓥	鎣
蓦	驀
蔷	薔
蔹	蘞
蔺	藺
蔼	藹
蕲	蘄
蕴	蘊
薮	藪
藁	槁
藓	蘚
蘖	蘗
虏	虜
虑	慮
虚	虛
虫	蟲
虬	虯
虮	蟣
虽	雖
虾	蝦
虿	蠆
蚀	蝕
蚁	蟻
蚂	螞
蚕	蠶
蚬	蜆
蛊	蠱
蛎	蠣
蛏	蟶
蛮	蠻
蛰	蟄
蛱	蛺
蛲	蟯
蛳	螄
蛴	蠐
蜕	蛻
蜖	汀
蜗	蝸
蜡	蠟
蝇	蠅
蝈	蟈
蝉	蟬
蝎	蠍
蝼	螻
蝾	蠑
蝿	蠅
螀	螿
螨	顢
蟏	蠨
蟮	蟺
蠎	蟒
蠼	蠼
衅	釁
衔	銜
衤	衣
补	補
表	表
衬	襯
衮	袞
袄	襖
袅	裊
袆	褘
袜	襪
袭	襲
袯	襏
袴	褲
装	裝
裆	襠
裈	褌
裢	褳
裣	襝
裤	褲
裥	襉
褛	褸
褴	襤
襕	襴
覇	霸
覚	覺
覧	覽
覩	睹
见	見
观	觀
规	規
觅	覓
视	視
觇	覘
览	覽
觉	覺
觊	覬
觋	覡
觌	覿
觎	覦
觏	覯
觐	覲
觑	覷
觗	觝
觞	觴
触	觸
觯	觶
訡	吟
詟	讋
詤	謊
誀	浴
誉	譽
誊	謄
説	說
読	讀
讁	謫
讠	言
计	計
订	訂
讣	訃
认	認
讥	譏
讦	訐
讧	訌
讨	討
让	讓
讪	訕
讫	訖
训	訓
议	議
讯	訊
记	記
讱	訒
讲	講
讳	諱
讴	謳
讵	詎
讶	訝
讷	訥
许	許
讹	訛
论	論
讼	訟
讽	諷
设	設
访	訪
诀	訣
证	証
诂	詁
诃	訶
评	評
诅	詛
识	識
诇	詗
诈	詐
诉	訴
诊	診
诋	詆
诌	謅
词	詞
诎	詘
诏	詔
诐	詖
译	譯
诒	詒
诓	誆
诔	誄
试	試
诖	詿
诗	詩
诘	詰
诙	詼
诚	誠
诛	誅
诜	詵
话	話
诞	誕
诟	詬
诠	詮
诡	詭
询	詢
诣	詣
诤	諍
该	該
详	詳
诧	詫
诨	諢
诩	詡
诪	譸
诫	誡
诬	誣
语	語
诮	誚
误	誤
诰	誥
诱	誘
诲	誨
诳	誑
说	說
诵	誦
诶	誒
请	請
诸	諸
诹	諏
诺	諾
读	讀
诼	諑
诽	誹
课	課
诿	諉
谀	諛
谁	誰
谂	諗
调	調
谄	諂
谅	諒
谆	諄
谇	誶
谈	談
谊	誼
谋	謀
谌	諶
谍	諜
谎	謊
谏	諫
谐	諧
谑	謔
谒	謁
谓	謂
谔	諤
谕	諭
谖	諼
谗	讒
谘	諮
谙	諳
谚	諺
谛	諦
谜	謎
谝	諞
谞	住
谟	謨
谠	讜
谡	謖
谢	謝
谣	謠
谤	謗
谥	謚
谦	謙
谧	謐
谨	謹
谩	謾
谪	謫
谫	譾
谬	謬
谭	譚
谮	譖
谯	譙
谰	讕
谱	譜
谲	譎
谳	讞
谴	譴
谵	譫
谶	讖
谷	谷
豆	豆
豮	豶
貭	亍
貮	貳
賍	贓
賎	賤
賖	賒
賘	髒
贋	贗
贘	償
贝	貝
贞	貞
负	負
贡	貢
财	財
责	責
贤	賢
败	敗
账	賬
货	貨
质	質
贩	販
贪	貪
贫	貧
贬	貶
购	購
贮	貯
贯	貫
贰	貳
贱	賤
贲	賁
贳	貰
贴	貼
贵	貴
贶	貺
贷	貸
贸	貿
费	費
贺	賀
贻	貽
贼	賊
贽	贄
贾	賈
贿	賄
赀	貲
赁	賃
赂	賂
赃	贓
资	資
赅	賅
赆	贐
赇	賕
赈	賑
赉	賚
赊	賒
赋	賦
赌	賭
赍	齎
赎	贖
赏	賞
赐	賜
赑	贔
赒	賙
赓	賡
赔	賠
赕	賧
赖	賴
赗	賵
赘	贅
赙	賻
赚	賺
赛	賽
赜	賾
赝	贗
赞	贊
赟	贇
赠	贈
赡	贍
赢	贏
赣	贛
赪	赬
赵	趙
赶	趕
趋	趨
趱	趲
趸	躉
跃	躍
跄	蹌
跞	躒
践	踐
跶	躂
跷	蹺
跸	蹕
跹	躚
跻	躋
踊	踊
踌	躊
踪	蹤
踬	躓
踯	躑
蹑	躡
蹒	蹣
蹰	躕
蹿	躥
躏	躪
躜	躦
躯	軀
车	車
轧	軋
轨	軌
轩	軒
轪	軑
轫	軔
转	轉
轭	軛
轮	輪
软	軟
轰	轟
轱	古
轲	軻
轳	轤
轴	軸
轵	軹
轶	軼
轷	乎
轸	軫
轹	轢
轺	軺
轻	輕
轼	軾
载	載
轾	輊
轿	轎
辀	輈
辁	輇
辂	輅
较	較
辄	輒
辅	輔
辆	輛
辇	輦
辈	輩
辉	輝
辊	輥
辋	輞
辌	輬
辍	輟
辎	輜
辏	輳
辐	輻
辑	輯
辒	轀
输	輸
辔	轡
辕	轅
辖	轄
辗	輾
辘	轆
辙	轍
辚	轔
辞	辭
辟	闢
辩	辯
辫	辮
辬	辨
边	邊
辽	遼
达	達
迁	遷
过	過
迈	邁
运	運
还	還
这	這
进	進
远	遠
违	違
连	連
迟	遲
迩	邇
迳	逕
迹	跡
适	適
选	選
逊	遜
递	遞
逦	邐
逻	邏
逼	逼
逾	逾
遗	遺
遥	遙
邓	鄧
邝	鄺
邬	鄔
邮	郵
邹	鄒
邺	鄴
邻	鄰
郁	鬱
郄	卻
郏	郟
郐	鄶
郑	鄭
郓	鄆
郦	酈
郧	鄖
郷	鄉
郸	鄲
鄊	鄉
鄕	鄉
鄷	酆
酝	醞
酦	醱
酰	⺶
酱	醬
酸	酸
酽	釅
酾	釃
酿	釀
采	採
释	釋
里	里
釡	斧
鉴	鑒
銮	鑾
錾	鏨
鍫	濉
鎻	鎖
钅	金
钆	釓
钇	釔
针	針
钉	釘
钊	釗
钋	釙
钌	釕
钍	釷
钎	鐱
钏	釧
钐	釤
钑	鈒
钒	釩
钓	釣
钔	鍆
钕	釹
钖	鍚
钗	釵
钘	鈃
钙	鈣
钚	鈽
钛	鈦
钜	鉅
钝	鈍
钞	鈔
钟	鐘
钠	鈉
钡	鋇
钢	鋼
钣	鈑
钤	鈐
钥	鑰
钦	欽
钧	鈞
钨	鎢
钩	鉤
钪	鈧
钫	鈁
钬	鈥
钭	鈄
钮	鈕
钯	鈀
钰	鈺
钱	錢
钲	鉦
钳	鉗
钴	鈷
钵	缽
钶	鈳
钷	鏂
钸	鈽
钹	鈸
钺	鉞
钻	鑽
钼	鉬
钽	鉭
钾	鉀
钿	鈿
铀	鈾
铁	鐵
铂	鉑
铃	鈴
铄	鑠
铅	鉛
铆	鉚
铈	鈰
铉	鉉
铊	鉈
铋	鉍
铌	鈮
铍	鈹
铎	鐸
铏	鉶
铐	銬
铑	銠
铒	鉺
铓	鋩
铔	錏
铕	銪
铖	鋮
铗	鋏
铘	邪
铙	鐃
铚	銍
铛	鐺
铜	銅
铝	鋁
铞	吊
铟	銦
铠	鎧
铡	鍘
铢	銖
铣	銑
铤	鋌
铥	銩
铦	銛
铧	鏵
铨	銓
铩	鎩
铪	鉿
铫	銚
铬	鉻
铭	銘
铮	錚
铯	銫
铰	鉸
铱	銥
铲	鏟
铳	銃
铴	鐋
铵	銨
银	銀
铷	銣
铸	鑄
铹	鐒
铺	鋪
铻	鋙
铼	錸
铽	鋱
链	鏈
铿	鏗
销	銷
锁	鎖
锂	鋰
锃	呈
锄	鋤
锅	鍋
锆	鋯
锇	鋨
锈	鏽
锉	銼
锊	鋝
锋	鋒
锌	鋅
锍	琉
锎	鉲
锏	閒
锐	銳
锑	銻
锒	鋃
锓	鋟
锔	鋦
锕	錒
锖	錆
锗	鍺
锘	若
错	錯
锚	錨
锛	錛
锜	錡
锝	鎝
锞	錁
锟	錕
锠	琛
锡	錫
锢	錮
锣	鑼
锤	錘
锥	錐
锦	錦
锧	鑕
锨	杴
锩	錈
锪	忽
锫	培
锬	錟
锭	錠
键	鍵
锯	鋸
锰	錳
锱	錙
锲	鍥
锴	鍇
锵	鏘
锶	鍶
锷	鍔
锸	鍤
锹	鍬
锺	鍾
锻	鍛
锼	鎪
锽	鍠
锾	鍰
锿	鑀
镀	鍍
镁	鎂
镂	鏤
镃	鎡
镄	鐨
镅	鋂
镆	鏌
镇	鎮
镈	鎛
镉	鎘
镊	鑷
镋	钂
镌	鐫
镍	鎳
镎	拿
镏	鎦
镐	鎬
镑	鎊
镒	鎰
镓	鎵
镔	鑌
镕	鎔
镖	鏢
镗	鏜
镘	鏝
镙	鏍
镛	鏞
镜	鏡
镝	鏑
镞	鏃
镟	鏇
镠	鏐
镡	鐔
镢	钁
镣	鐐
镤	鏷
镥	魯
镦	鐓
镧	鑭
镨	鐠
镩	串
镪	鏹
镫	鐙
镬	鑊
镭	鐳
镮	鐶
镯	鐲
镰	鐮
镱	鐿
镲	察
镳	鑣
镴	鑞
镵	鑱
镶	鑲
长	長
閲	閱
门	門
闩	閂
闪	閃
闫	閆
闬	閈
闭	閉
问	問
闯	闖
闰	閏
闱	闈
闲	閒
闳	閎
间	間
闵	閔
闶	閌
闷	悶
闸	閘
闹	鬧
闺	閨
闻	聞
闼	闥
闽	閩
闾	閭
闿	闓
阀	閥
阁	閣
阂	閡
阃	閫
阄	鬮
阅	閱
阆	閬
阇	闍
阈	閾
阉	閹
阊	閶
阋	鬩
阌	閿
阍	閽
阎	閻
阏	閼
阐	闡
阑	闌
阒	闃
阓	闠
阔	闊
阕	闋
阖	闔
阗	闐
阘	闒
阙	闕
阚	闞
阛	闤
阝	阜
队	隊
阳	陽
阴	陰
阵	陣
阶	階
际	際
陆	陸
陇	隴
陈	陳
陉	陘
陕	陝
陧	隉
陨	隕
险	險
陶	陶
隂	陰
隌	暗
随	隨
隐	隱
隠	隱
隶	隸
隷	隸
隽	雋
难	難
雇	雇
雏	雛
雕	雕
雠	讎
雳	靂
雾	霧
霁	霽
霊	靈
霭	靄
靓	靚
静	靜
面	面
靥	靨
鞑	韃
鞒	轎
鞯	韉
鞲	韝
鞴	鞁
鞽	轎
韦	韋
韧	韌
韨	韍
韩	韓
韪	韙
韫	韞
韬	韜
韯	籤
韲	齋
韵	韻
顋	腮
顔	顏
顕	顯
页	頁
顶	頂
顷	頃
顸	頇
项	項
顺	順
须	須
顼	頊
顽	頑
顾	顧
顿	頓
颀	頎
颁	頒
颂	頌
颃	頏
预	預
颅	顱
领	領
颇	頗
颈	頸
颉	頡
颊	頰
颋	頲
颌	頜
颍	潁
颎	熲
颏	頦
颐	頤
频	頻
颓	頹
颔	頷
颕	穎
颖	穎
颗	顆
题	題
颙	顒
颚	顎
颛	顓
颜	顏
额	額
颞	顳
颟	顢
颠	顛
颡	顙
颢	顥
颣	纇
颤	顫
颥	須
颦	顰
颧	顴
颷	飆
风	風
飏	颺
飐	颭
飑	颮
飒	颯
飓	颶
飔	颸
飕	颼
飖	颻
飗	飀
飘	飄
飙	飆
飚	飆
飞	飛
飨	饗
飬	養
飮	飲
飱	餐
餍	饜
饊	ø
饣	食
饤	飣
饥	飢
饦	飥
饧	餳
饨	飩
饩	餼
饪	飪
饫	飫
饬	飭
饭	飯
饮	飲
饯	餞
饰	飾
饱	飽
饲	飼
饴	飴
饵	餌
饶	饒
饷	餉
饺	餃
饼	餅
饽	餑
饾	餖
饿	餓
馀	餘
馁	餒
馂	餕
馄	餛
馅	餡
馆	館
馇	查
馈	饋
馉	稹
馊	餿
馋	饞
馌	饁
馍	饃
馎	餺
馏	餾
馐	饈
馑	饉
馒	饅
馓	ø
馔	饌
馕	囊
马	馬
驭	馭
驮	馱
驯	馴
驰	馳
驱	驅
驲	馹
驳	駁
驴	驢
驵	駔
驶	駛
驷	駟
驸	駙
驹	駒
驺	騶
驻	駐
驼	駝
驽	駑
驾	駕
驿	驛
骀	駘
骁	驍
骂	罵
骃	駰
骄	驕
骅	驊
骆	駱
骇	駭
骈	駢
骉	驫
骊	驪
骋	騁
验	驗
骍	騂
骎	駸
骏	駿
骐	騏
骑	騎
骒	騍
骓	騅
骕	驌
骖	驂
骗	騙
骘	騭
骙	騤
骚	騷
骛	騖
骜	驁
骝	騮
骞	騫
骟	騸
骠	驃
骡	騾
骢	驄
骣	驏
骤	驟
骥	驥
骦	驦
骧	驤
髅	髏
髋	髖
髌	髕
鬓	鬢
魇	魘
魉	魎
鱼	魚
鱽	魛
鱿	魷
鲀	魨
鲁	魯
鲂	魴
鲄	魺
鲅	鱍
鲆	平
鲇	占
鲈	鱸
鲊	鮓
鲋	鮒
鲍	鮑
鲎	鱟
鲐	鮐
鲑	鮭
鲒	鮚
鲔	鮪
鲕	鮞
鲖	鮦
鲙	鱠
鲚	鱭
鲛	鮫
鲜	鮮
鲞	鯗
鲟	鱘
鲠	鯁
鲡	鱺
鲢	鰱
鲣	鰹
鲤	鯉
鲥	鰣
鲦	鰷
鲧	鯀
鲨	鯊
鲩	鯇
鲪	鮶
鲫	鯽
鲭	鯖
鲮	鯪
鲯	鯕
鲰	鯫
鲱	鯡
鲲	鯤
鲳	鯧
鲴	固
鲵	鯢
鲶	鯰
鲷	鯛
鲸	鯨
鲺	虱
鲻	鯔
鲼	賁
鲽	鰈
鲿	鱨
鳀	鯷
鳃	鰓
鳄	鱷
鳅	鰍
鳆	鰒
鳇	鰉
鳊	扁
鳋	蚤
鳌	鰲
鳍	鰭
鳎	鰨
鳏	鰥
鳐	鰩
鳒	鰜
鳓	鰳
鳔	鰾
鳕	鱈
鳖	鱉
鳗	鰻
鳘	鱉
鳙	庸
鳛	鰼
鳜	鱖
鳝	鱔
鳞	鱗
鳟	鱒
鳡	鰲
鳢	鱧
鳣	鱣
鸟	鳥
鸠	鳩
鸡	雞
鸢	鳶
鸣	鳴
鸤	鳲
鸥	鷗
鸦	鴉
鸧	鶬
鸨	鴇
鸩	鴆
鸪	鴣
鸫	鶇
鸬	鸕
鸭	鴨
鸮	鴞
鸯	鴦
鸰	鴒
鸱	鴟
鸲	鴝
鸳	鴛
鸵	鴕
鸶	鷥
鸷	鷙
鸸	鴯
鸹	鴰
鸺	鵂
鸼	鵃
鸽	鴿
鸾	鸞
鸿	鴻
鹁	鵓
鹂	鸝
鹃	鵑
鹄	鵠
鹅	鵝
鹆	鵒
鹇	鷳
鹈	鵜
鹉	鵡
鹊	鵲
鹋	苗
鹌	鵪
鹎	鵯
鹏	鵬
鹑	鶉
鹒	鶊
鹓	鵷
鹔	鷫
鹕	鶘
鹖	鶡
鹗	鶚
鹘	鶻
鹙	鶖
鹚	鶿
鹛	眉
鹜	鶩
鹝	鷊
鹞	鷂
鹟	鶲
鹠	鶹
鹡	鶺
鹢	鷁
鹣	鶼
鹤	鶴
鹥	鷖
鹦	鸚
鹧	鷓
鹨	鷚
鹩	鷯
鹪	鷦
鹫	鷲
鹬	鷸
鹭	鷺
鹯	鸇
鹰	鷹
鹱	獲
鹲	鸏
鹳	鸛
鹾	鹺
麦	麥
麸	麩
麹	麴
麺	麵
麻	麻
麽	麼
黄	黃
黉	黌
黒	黑
黙	默
黡	黶
黩	黷
黪	黲
黾	黽
鼋	黿
鼍	鼉
鼗	鞀
鼹	鼴
齄	皻
齐	齊
齑	齏
齿	齒
龀	齔
龁	齕
龂	齗
龃	齟
龄	齡
龅	齙
龆	齠
龇	齜
龈	齦
龉	齬
龊	齪
龋	齲
龌	齷
龙	龍
龚	龔
龛	龕
龟	龜
